Adenomera_andreae	0
Agalychnis_spurrelli	0
Allobates_femoralis	0
Allobates_humilis	0
Allobates_juanii	0
Allobates_kingsburyi	0
Allobates_spCanelos	0
Allobates_talamancae	0
Allobates_zaparo	0
Amazophrynella_minuta	0
Ambystoma_mexicanum	NA
Ambystoma_tigrinum	1
Ameerega_bassleri	1
Ameerega_bilinguis	1
Ameerega_hahneli	1
Ameerega_parvula	1
Ameerega_trivittata	1
Amietia_hymenopus	NA
Andrias_davidianus	1
Anomaloglossus_verbeeksnyderorum	0
Aromobates_alboguttatussp2	0
Aromobates_saltuensis	0
Atelopus_flavescens	1
Atelopus_glyphus	1
Atelopus_ignescens	1
Atelopus_limosus	1
Atelopus_newspecies	NA
Atelopus_spumarius	1
Atelopus_spurrelli	1
Atelopus_varius	1
Atelopus_exiguus	NA
Brachycephalus_boticario	1
Brachycephalus_brunneus	NA
Brachycephalus_izeckesohni	1
Brachycephalus_olivaceus	NA
Brachycephalus_pernix	1
Brachycephalus_pombali	1
Bufo_bufo	1
Bufo_viridis	NA
Calotriton_asper	NA
Centrolene_heloderma	0
Ceratophrys_cornuta	NA
Cochranella_resplendens	0
Colostethus_panamansis	1
Colostethus_pratti	0
Craugastor_longirostris	0
Cynops_pyrrhogaster	1
Dendrobates_auratus	1
Dendrobates_bombetes	1
Dendrobates_captivus	1
Dendrobates_fantasticus	1
Dendrobates_fulguritus	1
Dendrobates_galactonotus	1
Dendrobates_histrionicus	1
Dendrobates_imitator	1
Dendrobates_leucomelas	1
Dendrobates_pumilio	1
Dendrobates_tinctorius	1
Dendrobates_ventrimaculatus	1
Discoglossus_pictus	NA
Epipedobates_anthonyi	1
Epipedobates_boulengerisEspinosai	NA
Epipedobates_boulengerisSS	1
Epipedobates_darwinwallacei	1
Epipedobates_machalilla	1
Epipedobates_narinensis	NA
Epipedobates_tricolor	1
Fejervarya_limnocharis	NA
Hyla_arborea	NA
Hyla_cinerea	NA
Hyloxalus_awa	0
Hyloxalus_azureiventris	0
Hyloxalus_bocagei	0
Hyloxalus_delatorreae	0
Hyloxalus_infraguttatus	0
Hyloxalus_jacobuspetersi	0
Hyloxalus_nexipus	0
Hyloxalus_pulchellus	0
Hyloxalus_shuar	0
Hyloxalus_spCopal	0
Hyloxalus_vertebralis	0
Hyloxalus_yasuni	0
Hymenochirus_curtipes	0
Hynobius_chinensis	NA
Hynobius_retardatus	NA
Iranodon_persicus	NA
Ischnocnema_paranaensis	NA
Leptobrachium_boringii	NA
Leucostethus_fraterdanieli	NA
Leucostethus_fugax	0
Limnodynastes_peronii	NA
Lithodytes_lineatus	1
Mannophryne_collaris	NA
Mannophryne_cordilleriana	NA
Mannophryne_riveroi	0
Mannophryne_venezuelensis	NA
Mantella_baroni	1
Mantidactylus_betsileanus	NA
Melanophryniscus_stelzneri	1
Microcaecilia_unicolor	NA
Microhyla_fissipes	0
Nanorana_parkeri	NA
Notophthalmus_viridescens	1
Odorrana_margaretae	NA
Odorrana_tormota	NA
Oreolalax_rhodostigmatus	NA
Osornophryne_antisana	NA
Pelobates_cultripes	NA
Phyllobates_aurotaenia	1
Phyllobates_terribilis	1
Phyllobates_vittatus	1
Pleurodeles_waltl	1
Pyxicephalus_adspersus	NA
Quasipaa_boulengeri	NA
Rana_catesbeiana	0
Rana_pipiens	NA
Rana_temporaria	NA
Rheobates_palmatus	0
Rhinatrema_bivittatum	NA
Rhinella_marina	1
Rhinella_spinulosa	NA
Salamandra_infraimmaculata	1
Salamandra_salamandra	1
Scaphiopus_couchii	NA
Silverstoneia_erasmios	NA
Silverstoneia_flotator	0
Telmatobius_jelskii	NA
Telmatobius_marmoratus	NA
Xenopus_laevis	NA
Xenopus_tropicalis	NA
